1214,1214,1214,1214,1214,1214,1214,1214,1214,1214,1214,1214,1214,1214,1214,1214,1214,1214,1214,1214,1214,1214,1214,1214,1214,1214,1214,1214,1214,1214,1214,1214,1214,1214,1214,1214,1214,1214,1214,1214,1214,1214,1214,1214,1214,1214,1214,1214,1214,1214,1214,1214,1214,1214,1214,1214,1214,1214,1214,1214,1214,1214,1214,1214,1214,1214,1214,1214,1214,1214,1214,1214,1214,1214,1214,1214,1214,1214,1214,1214,1214,1214,1214,1214,1214,1214,1214,1214,1214,1214,1214,1214,1214,1214,1214,1214,1214,1214,1214,1214,1214,1214,1214,1214,1214,1214,1214,1214,1214,1214,1214,1214,1214,1214,1214,1214,1214,1214,1214,1214,1214,1214,1214,1214,1214,1214,1214,1214,1214,1214,1214,1214,1214,1214,1214,1214,1214,1214,1214,1214,1214,1214,1214,1214,1214,1214,1214,1214,1214,1214,1214,1214,1214,1214,1214,1214,1214,1214,1214,1214,1214,1214,1214,1214,1214,1214,1214,1214,1214,1214,1214,1214,1214,1214,1214,1214,1214,1214,1214,1214,1214,1214,1214,1214,1214,1214,1214,1214,1214,1214,1214,1214,1214,1214,1214,1214,1214,1214,1214,1214,
1214,1214,1214,1214,1214,1214,1214,1214,1214,1214,1214,1214,1214,1214,1214,1214,1214,1214,1214,1214,1214,1214,1214,1214,1214,1214,1214,1214,1214,1214,1214,1214,1214,1214,1214,1214,1214,1214,1214,1214,1214,1214,1214,1214,1214,1214,1214,1214,1214,1214,1214,1214,1214,1214,1214,1214,1214,1214,1214,1214,1214,1214,1214,1214,1214,1214,1214,1214,1214,1214,1214,1214,1214,1214,1214,1214,1214,1214,1214,1214,1214,1214,1214,1214,1214,1214,1214,1214,1214,1214,1214,1214,1214,1214,1214,1214,1214,1214,1214,1214,1214,1214,1214,1214,1214,1214,1214,1214,1214,1214,1214,1214,1214,1214,1214,1214,1214,1214,1214,1214,1214,1214,1214,1214,1214,1214,1214,1214,1214,1214,1214,1214,1214,1214,1214,1214,1214,1214,1214,1214,1214,1214,1214,1214,1214,1214,1214,1214,1214,1214,1214,1214,1214,1214,1214,1214,1214,1214,1214,1214,1214,1214,1214,1214,1214,1214,1214,1214,1214,1214,1214,1214,1214,1214,1214,1214,1214,1214,1214,1214,1214,1214,1214,1214,1214,1214,1214,1214,1214,1214,1214,1214,1214,1214,1214,1214,1214,1214,1214,1214,
1214,1214,1214,1214,1214,1214,1214,1214,1214,1214,1214,1214,1214,1214,1214,1214,1214,1214,1214,1214,1214,1214,1214,1214,1214,1214,1214,1214,1214,1214,1214,1214,1214,1214,1214,1214,1214,1214,1214,1214,1214,1214,1214,1214,1214,1214,1214,1214,1214,1214,1214,1214,1214,1214,1214,1214,1214,1214,1214,1214,1214,1214,1214,1214,1214,1214,1214,1214,1214,1214,1214,1214,1214,1214,1214,1214,1214,1214,1214,1214,1214,1214,1214,1214,1214,1214,1214,1214,1214,1214,1214,1214,1214,1214,1214,1214,1214,1214,1214,1214,1214,1214,1214,1214,1214,1214,1214,1214,1214,1214,1214,1214,1214,1214,1214,1214,1214,1214,1214,1214,1214,1214,1214,1214,1214,1214,1214,1214,1214,1214,1214,1214,1214,1214,1214,1214,1214,1214,1214,1214,1214,1214,1214,1214,1214,1214,1214,1214,1214,1214,1214,1214,1214,1214,1214,1214,1214,1214,1214,1214,1214,1214,1214,1214,1214,1214,1214,1214,1214,1214,1214,1214,1214,1214,1214,1214,1214,1214,1214,1214,1214,1214,1214,1214,1214,1214,1214,1214,1214,1214,1214,1214,1214,1214,1214,1214,1214,1214,1214,1214,
1214,1214,1214,1214,1214,1214,1214,1214,1214,1214,1214,1214,1214,1214,1214,1214,1214,1214,1214,1214,1214,1214,1214,1214,1214,1214,1214,1214,1214,1214,1214,1214,1214,1214,1214,1214,1214,1214,1214,1214,1214,1214,1214,1214,1214,1214,1214,1214,1214,1214,1214,1214,1214,1214,1214,1214,1214,1214,1214,1214,1214,1214,1214,1214,1214,1214,1214,1214,1214,1214,1214,1214,1214,1214,1214,1214,1214,1214,1214,1214,1214,1214,1214,1214,1214,1214,1214,1214,1214,1214,1214,1214,1214,1214,1214,1214,1214,1214,1214,1214,1214,1214,1214,1214,1214,1214,1214,1214,1214,1214,1214,1214,1214,1214,1214,1214,1214,1214,1214,1214,1214,1214,1214,1214,1214,1214,1214,1214,1214,1214,1214,1214,1214,1214,1214,1214,1214,1214,1214,1214,1214,1214,1214,1214,1214,1214,1214,1214,1214,1214,1214,1214,1214,1214,1214,1214,1214,1214,1214,1214,1214,1214,1214,1214,1214,1214,1214,1214,1214,1214,1214,1214,1214,1214,1214,1214,1214,1214,1214,1214,1214,1214,1214,1214,1214,1214,1214,1214,1214,1214,1214,1214,1214,1214,1214,1214,1214,1214,1214,1214,
1214,1214,1214,1214,1214,1214,0,0,0,0,0,0,0,0,0,0,0,0,0,0,0,0,0,0,0,0,0,0,0,0,0,0,0,0,0,0,0,0,0,0,0,0,0,0,0,0,0,0,0,0,0,0,0,0,0,0,0,0,0,0,0,0,0,0,0,0,0,0,0,0,0,0,0,0,0,0,0,0,0,0,0,0,0,0,0,0,0,0,0,0,0,0,0,0,0,0,0,0,0,0,0,0,0,0,0,0,0,0,0,0,0,0,0,0,0,0,0,0,0,0,0,0,0,0,0,0,0,0,0,0,0,0,0,0,0,0,0,0,0,0,0,0,0,0,0,0,0,0,0,0,0,0,0,0,0,0,0,0,0,0,0,0,0,0,0,0,0,0,0,0,0,0,0,0,0,0,0,0,0,0,0,0,0,0,0,0,0,0,0,0,0,0,0,0,1214,1214,1214,1214,1214,1214,
1214,1214,1214,1214,1214,1214,0,0,0,0,0,0,0,0,0,0,0,0,0,0,0,0,0,0,0,0,0,0,0,0,0,0,0,0,0,0,0,0,0,0,0,0,0,0,0,0,0,0,0,0,0,0,0,0,0,0,0,0,0,0,0,0,0,0,0,0,0,0,0,0,0,0,0,0,0,0,0,0,0,0,0,0,0,0,0,0,0,0,0,0,0,0,0,0,0,0,0,0,0,0,0,0,0,0,0,0,0,0,0,0,0,0,0,0,0,0,0,0,0,0,0,0,0,0,0,0,0,0,0,0,0,0,0,0,0,0,0,0,0,0,0,0,0,0,0,0,0,0,0,0,0,0,0,0,0,0,0,0,0,0,0,0,0,0,0,0,0,0,0,0,0,0,0,0,0,0,0,0,0,0,0,0,0,0,0,0,0,0,0,0,0,0,0,0,1214,1214,1214,1214,1214,1214,
1214,1214,1214,1214,1214,1214,0,0,0,0,0,0,0,0,0,0,0,0,0,0,0,0,0,0,0,0,0,0,0,0,0,0,0,0,0,0,0,0,0,0,0,0,0,0,0,0,0,0,0,0,0,0,0,0,0,0,0,0,0,0,0,0,0,0,0,0,0,0,0,0,0,0,0,0,0,0,0,0,0,0,0,0,0,0,0,0,0,0,0,0,0,0,0,0,0,0,0,0,0,0,0,0,0,0,0,0,0,0,0,0,0,0,0,0,0,0,0,0,0,0,0,0,0,0,0,0,0,0,0,0,0,0,0,0,0,0,0,0,0,0,0,0,0,0,0,0,0,0,0,0,0,0,0,0,0,0,0,0,0,0,0,0,0,0,0,0,0,0,0,0,0,0,0,0,0,0,0,0,0,0,0,0,0,0,0,0,0,0,0,0,0,0,0,0,1214,1214,1214,1214,1214,1214,
1214,1214,1214,1214,1214,1214,0,0,0,0,0,0,0,0,0,0,0,0,0,0,0,0,0,0,0,0,0,0,0,0,0,0,0,0,0,0,0,0,0,0,0,0,0,0,0,0,0,0,0,0,0,0,0,0,0,0,0,0,0,0,0,0,0,0,0,0,0,0,0,0,0,0,0,0,0,0,0,0,0,0,0,0,0,0,0,0,0,0,0,0,0,0,0,0,0,0,0,0,0,0,0,0,0,0,0,0,0,0,0,0,0,0,0,0,0,0,0,0,0,0,0,0,0,0,0,0,0,0,0,0,0,0,0,0,0,0,0,0,0,0,0,0,0,0,0,0,0,0,0,0,0,0,0,0,0,0,0,0,0,0,0,0,0,0,0,0,0,0,0,0,0,0,0,0,0,0,0,0,0,0,0,0,0,0,0,0,0,0,0,0,0,0,0,0,1214,1214,1214,1214,1214,1214,
1214,1214,1214,1214,1214,1214,0,0,0,0,0,0,0,0,0,0,0,0,0,0,0,0,0,0,0,0,0,0,0,0,0,0,0,0,0,0,0,0,0,0,0,0,0,0,0,0,0,0,0,0,0,0,0,0,0,0,0,0,0,0,0,0,0,0,0,0,0,0,0,0,0,0,0,0,0,0,0,0,0,0,0,0,0,0,0,0,0,0,0,0,0,0,0,0,0,0,0,0,0,0,0,0,0,0,0,0,0,0,0,0,0,0,0,0,0,0,0,0,0,0,0,0,0,0,0,0,0,0,0,0,0,0,0,0,0,0,0,0,0,0,0,0,0,0,0,0,0,0,0,0,0,0,0,0,0,0,0,0,0,0,0,0,0,0,0,0,0,0,0,0,0,0,0,0,0,0,0,0,0,0,0,0,0,0,0,0,0,0,0,0,0,0,0,0,1214,1214,1214,1214,1214,1214,
1214,1214,1214,1214,1214,1214,0,0,0,0,0,0,0,0,0,0,0,0,0,0,0,0,0,0,0,0,0,0,0,0,0,0,0,0,0,0,0,0,0,0,0,0,0,0,0,0,0,0,0,0,0,0,0,0,0,0,0,0,0,0,0,0,0,0,0,0,0,0,0,0,0,0,0,0,0,0,0,0,0,0,0,0,0,0,0,0,0,0,0,0,0,0,0,0,0,0,0,0,0,0,0,0,0,0,0,0,0,0,0,0,0,0,0,0,0,0,0,0,0,0,0,0,0,0,0,0,0,0,0,0,0,0,0,0,0,0,0,0,0,0,0,0,0,0,0,0,0,0,0,0,0,0,0,0,0,0,0,0,0,0,0,0,0,0,0,0,0,0,0,0,0,0,0,0,0,0,0,0,0,0,0,0,0,0,0,0,0,0,0,0,0,0,0,0,1214,1214,1214,1214,1214,1214,
1214,1214,1214,1214,1214,1214,0,0,0,0,0,0,0,0,0,0,0,0,0,0,0,0,0,0,0,0,0,0,0,0,0,0,0,0,0,0,0,0,0,0,0,0,0,0,0,0,0,0,0,0,0,0,0,0,0,0,0,0,0,0,0,0,0,0,0,0,0,0,0,0,0,0,0,0,0,0,0,0,0,0,0,0,0,0,0,0,0,0,0,0,0,0,0,0,0,0,0,0,0,0,0,0,0,0,0,0,0,0,0,0,0,0,0,0,0,0,0,0,0,0,0,0,0,0,0,0,0,0,0,0,0,0,0,0,0,0,0,0,0,0,0,0,0,0,0,0,0,0,0,0,0,0,0,0,0,0,0,0,0,0,0,0,0,0,0,0,0,0,0,0,0,0,0,0,0,0,0,0,0,0,0,0,0,0,0,0,0,0,0,0,0,0,0,0,1214,1214,1214,1214,1214,1214,
1214,1214,1214,1214,1214,1214,0,0,0,0,0,0,0,0,0,0,0,0,0,0,0,0,0,0,0,0,0,0,0,0,0,0,0,0,0,0,0,0,0,0,0,0,0,0,0,0,0,0,0,0,0,0,0,0,0,0,0,0,0,0,0,0,0,0,0,0,0,0,0,0,0,0,0,0,0,0,0,0,0,0,0,0,0,0,0,0,0,0,0,0,0,0,0,0,0,0,0,0,0,0,0,0,0,0,0,0,0,0,0,0,0,0,0,0,0,0,0,0,0,0,0,0,0,0,0,0,0,0,0,0,0,0,0,0,0,0,0,0,0,0,0,0,0,0,0,0,0,0,0,0,0,0,0,0,0,0,0,0,0,0,0,0,0,0,0,0,0,0,0,0,0,0,0,0,0,0,0,0,0,0,0,0,0,0,0,0,0,0,0,0,0,0,0,0,1214,1214,1214,1214,1214,1214,
1214,1214,1214,1214,1214,1214,0,0,0,0,0,0,0,0,0,0,0,0,0,0,0,0,0,0,0,0,0,0,0,0,0,0,0,0,0,0,0,0,0,0,0,0,0,0,0,0,0,0,0,0,0,0,0,0,0,0,0,0,0,0,0,0,0,0,0,0,0,0,0,0,0,0,0,0,0,0,0,0,0,0,0,0,0,0,0,0,0,0,0,0,0,0,0,0,0,0,0,0,0,0,0,0,0,0,0,0,0,0,0,0,0,0,0,0,0,0,0,0,0,0,0,0,0,0,0,0,0,0,0,0,0,0,0,0,0,0,0,0,0,0,0,0,0,0,0,0,0,0,0,0,0,0,0,0,0,0,0,0,0,0,0,0,0,0,0,0,0,0,0,0,0,0,0,0,0,0,0,0,0,0,0,0,0,0,0,0,0,0,0,0,0,0,0,0,1214,1214,1214,1214,1214,1214,
1214,1214,1214,1214,1214,1214,0,0,0,0,0,0,0,0,0,0,0,0,0,0,0,0,0,0,0,0,0,0,0,0,0,0,0,0,0,0,0,0,0,0,0,0,0,0,0,0,0,0,0,0,0,0,0,0,0,0,0,0,0,0,0,0,0,0,0,0,0,0,0,0,0,0,0,0,0,0,0,0,0,0,0,0,0,0,0,0,0,0,0,0,0,0,0,0,0,0,0,0,0,0,0,0,0,0,0,0,0,0,0,0,0,0,0,0,0,0,0,0,0,0,0,0,0,0,0,0,0,0,0,0,0,0,0,0,0,0,0,0,0,0,0,0,0,0,0,0,0,0,0,0,0,0,0,0,0,0,0,0,0,0,0,0,0,0,0,0,0,0,0,0,0,0,0,0,0,0,0,0,0,0,0,0,0,0,0,0,0,0,0,0,0,0,0,0,1214,1214,1214,1214,1214,1214,
1214,1214,1214,1214,1214,1214,0,0,0,0,0,0,0,0,0,0,0,0,0,0,0,0,0,0,0,0,0,0,0,0,0,0,0,0,0,0,0,0,0,0,0,0,0,0,0,0,0,0,0,0,0,0,0,0,0,0,0,0,0,0,0,0,0,0,0,0,0,0,0,0,0,0,0,0,0,0,0,0,0,0,0,0,0,0,0,0,0,0,0,0,0,0,0,0,0,0,0,0,0,0,0,0,0,0,0,0,0,0,0,0,0,0,0,0,0,0,0,0,0,0,0,0,0,0,0,0,0,0,0,0,0,0,0,0,0,0,0,0,0,0,0,0,0,0,0,0,0,0,0,0,0,0,0,0,0,0,0,0,0,0,0,0,0,0,0,0,0,0,0,0,0,0,0,0,0,0,0,0,0,0,0,0,0,0,0,0,0,0,0,0,0,0,0,0,1214,1214,1214,1214,1214,1214,
1214,1214,1214,1214,1214,1214,0,0,0,0,0,0,0,0,0,0,0,0,0,0,0,0,0,0,0,0,0,0,0,0,0,0,0,0,0,0,0,0,0,0,0,0,0,0,0,0,0,0,0,0,0,0,0,0,0,0,0,0,0,0,0,0,0,0,0,0,0,0,0,0,0,0,0,0,0,0,0,0,0,0,0,0,0,0,0,0,0,0,0,0,0,0,0,0,0,0,0,0,0,0,0,0,0,0,0,0,0,0,0,0,0,0,0,0,0,0,0,0,0,0,0,0,0,0,0,0,0,0,0,0,0,0,0,0,0,0,0,0,0,0,0,0,0,0,0,0,0,0,0,0,0,0,0,0,0,0,0,0,0,0,0,0,0,0,0,0,0,0,0,0,0,0,0,0,0,0,0,0,0,0,0,0,0,0,0,0,0,0,0,0,0,0,0,0,1214,1214,1214,1214,1214,1214,
1214,1214,1214,1214,1214,1214,0,0,0,0,0,0,0,0,0,0,0,0,0,0,0,0,0,0,0,0,0,0,0,0,0,0,0,0,0,0,0,0,0,0,0,0,0,0,0,0,0,0,0,0,0,0,0,0,0,0,0,0,0,0,0,0,0,0,0,0,0,0,0,0,0,0,0,0,0,0,0,0,0,0,0,0,0,0,0,0,0,0,0,0,0,0,0,0,0,0,0,0,0,0,0,0,0,0,0,0,0,0,0,0,0,0,0,0,0,0,0,0,0,0,0,0,0,0,0,0,0,0,0,0,0,0,0,0,0,0,0,0,0,0,0,0,0,0,0,0,0,0,0,0,0,0,0,0,0,0,0,0,0,0,0,0,0,0,0,0,0,0,0,0,0,0,0,0,0,0,0,0,0,0,0,0,0,0,0,0,0,0,0,0,0,0,0,0,1214,1214,1214,1214,1214,1214,
1214,1214,1214,1214,1214,1214,0,0,0,0,0,0,0,0,0,0,0,0,0,0,0,0,0,0,0,0,0,0,0,0,0,0,0,0,0,0,0,0,0,0,0,0,0,0,0,0,0,0,0,0,0,0,0,0,0,0,0,0,0,0,0,0,0,0,0,0,0,0,0,0,0,0,0,0,0,0,0,0,0,0,0,0,0,0,0,0,0,0,0,0,0,0,0,0,0,0,0,0,0,0,0,0,0,0,0,0,0,0,0,0,0,0,0,0,0,0,0,0,0,0,0,0,0,0,0,0,0,0,0,0,0,0,0,0,0,0,0,0,0,0,0,0,0,0,0,0,0,0,0,0,0,0,0,0,0,0,0,0,0,0,0,0,0,0,0,0,0,0,0,0,0,0,0,0,0,0,0,0,0,0,0,0,0,0,0,0,0,0,0,0,0,0,0,0,1214,1214,1214,1214,1214,1214,
1214,1214,1214,1214,1214,1214,0,0,0,0,0,0,0,0,0,0,0,0,0,0,0,0,0,0,0,0,0,0,0,0,0,0,0,0,0,0,0,0,0,0,0,0,0,0,0,0,0,0,0,0,0,0,0,0,0,0,0,0,0,0,0,0,0,0,0,0,0,0,0,0,0,0,0,0,0,0,0,0,0,0,0,0,0,0,0,0,0,0,0,0,0,0,0,0,0,0,0,0,0,0,0,0,0,0,0,0,0,0,0,0,0,0,0,0,0,0,0,0,0,0,0,0,0,0,0,0,0,0,0,0,0,0,0,0,0,0,0,0,0,0,0,0,0,0,0,0,0,0,0,0,0,0,0,0,0,0,0,0,0,0,0,0,0,0,0,0,0,0,0,0,0,0,0,0,0,0,0,0,0,0,0,0,0,0,0,0,0,0,0,0,0,0,0,0,1214,1214,1214,1214,1214,1214,
1214,1214,1214,1214,1214,1214,0,0,0,0,0,0,0,0,0,0,0,0,0,0,0,0,0,0,0,0,0,0,0,0,0,0,0,0,0,0,0,0,0,0,0,0,0,0,0,0,0,0,0,0,0,0,0,0,0,0,0,0,0,0,0,0,0,0,0,0,0,0,0,0,0,0,0,0,0,0,0,0,0,0,0,0,0,0,0,0,0,0,0,0,0,0,0,0,0,0,0,0,0,0,0,0,0,0,0,0,0,0,0,0,0,0,0,0,0,0,0,0,0,0,0,0,0,0,0,0,0,0,0,0,0,0,0,0,0,0,0,0,0,0,0,0,0,0,0,0,0,0,0,0,0,0,0,0,0,0,0,0,0,0,0,0,0,0,0,0,0,0,0,0,0,0,0,0,0,0,0,0,0,0,0,0,0,0,0,0,0,0,0,0,0,0,0,0,1214,1214,1214,1214,1214,1214,
1214,1214,1214,1214,1214,1214,0,0,0,0,0,0,0,0,0,0,0,0,0,0,0,0,0,0,0,0,0,0,0,0,0,0,0,0,0,0,0,0,0,0,0,0,0,0,0,0,0,0,0,0,0,0,0,0,0,0,0,0,0,0,0,0,0,0,0,0,0,0,0,0,0,0,0,0,0,0,0,0,0,0,0,0,0,0,0,0,0,0,0,0,0,0,0,0,0,0,0,0,0,0,0,0,0,0,0,0,0,0,0,0,0,0,0,0,0,0,0,0,0,0,0,0,0,0,0,0,0,0,0,0,0,0,0,0,0,0,0,0,0,0,0,0,0,0,0,0,0,0,0,0,0,0,0,0,0,0,0,0,0,0,0,0,0,0,0,0,0,0,0,0,0,0,0,0,0,0,0,0,0,0,0,0,0,0,0,0,0,0,0,0,0,0,0,0,1214,1214,1214,1214,1214,1214,
1214,1214,1214,1214,1214,1214,0,0,0,0,0,0,0,0,0,0,0,0,0,0,0,0,0,0,0,0,0,0,0,0,0,0,0,0,0,0,0,0,0,0,0,0,0,0,0,0,0,0,0,0,0,0,0,0,0,0,0,0,0,0,0,0,0,0,0,0,0,0,0,0,0,0,0,0,0,0,0,0,0,0,0,0,0,0,0,0,0,0,0,0,0,0,0,0,0,0,0,0,0,0,0,0,0,0,0,0,0,0,0,0,0,0,0,0,0,0,0,0,0,0,0,0,0,0,0,0,0,0,0,0,0,0,0,0,0,0,0,0,0,0,0,0,0,0,0,0,0,0,0,0,0,0,0,0,0,0,0,0,0,0,0,0,0,0,0,0,0,0,0,0,0,0,0,0,0,0,0,0,0,0,0,0,0,0,0,0,0,0,0,0,0,0,0,0,1214,1214,1214,1214,1214,1214,
1214,1214,1214,1214,1214,1214,0,0,0,0,0,0,0,0,0,0,0,0,0,0,0,0,0,0,0,0,0,0,0,0,0,0,0,0,0,0,0,0,0,0,0,0,0,0,0,0,0,0,0,0,0,0,0,0,0,0,0,0,0,0,0,0,0,0,0,0,0,0,0,0,0,0,0,0,0,0,0,0,0,0,0,0,0,0,0,0,0,0,0,0,0,0,0,0,0,0,0,0,0,0,0,0,0,0,0,0,0,0,0,0,0,0,0,0,0,0,0,0,0,0,0,0,0,0,0,0,0,0,0,0,0,0,0,0,0,0,0,0,0,0,0,0,0,0,0,0,0,0,0,0,0,0,0,0,0,0,0,0,0,0,0,0,0,0,0,0,0,0,0,0,0,0,0,0,0,0,0,0,0,0,0,0,0,0,0,0,0,0,0,0,0,0,0,0,1214,1214,1214,1214,1214,1214,
1214,1214,1214,1214,1214,1214,0,0,0,0,0,0,0,0,0,0,0,0,0,0,0,0,0,0,0,0,0,0,0,0,0,0,0,0,0,0,0,0,0,0,0,0,0,0,0,0,0,0,0,0,0,0,0,0,0,0,0,0,0,0,0,0,0,0,0,0,0,0,0,0,0,0,0,0,0,0,0,0,0,0,0,0,0,0,0,0,0,0,0,0,0,0,0,0,0,0,0,0,0,0,0,0,0,0,0,0,0,0,0,0,0,0,0,0,0,0,0,0,0,0,0,0,0,0,0,0,0,0,0,0,0,0,0,0,0,0,0,0,0,0,0,0,0,0,0,0,0,0,0,0,0,0,0,0,0,0,0,0,0,0,0,0,0,0,0,0,0,0,0,0,0,0,0,0,0,0,0,0,0,0,0,0,0,0,0,0,0,0,0,0,0,0,0,0,1214,1214,1214,1214,1214,1214,
1214,1214,1214,1214,1214,1214,0,0,0,0,0,0,0,1214,1214,1214,1214,1214,1214,1214,1214,1214,1214,1214,1214,1214,0,0,0,0,0,0,0,0,0,0,0,0,0,0,0,0,0,0,0,0,0,0,0,0,0,0,0,0,0,0,0,1214,1214,1214,1214,1214,1214,1214,0,0,0,0,0,0,0,0,0,0,0,0,0,0,0,0,0,0,0,0,0,0,0,0,0,0,0,0,0,0,0,0,0,0,0,0,0,0,0,0,0,0,0,0,0,0,0,0,0,0,0,0,0,0,0,0,0,0,0,0,0,0,0,0,0,0,0,0,0,0,0,0,1214,1214,1214,1214,1214,1214,1214,0,0,0,0,0,0,0,0,0,0,0,0,0,0,0,0,0,0,0,0,0,0,0,0,0,0,0,0,0,0,0,1214,1214,1214,1214,1214,1214,1214,1214,1214,1214,1214,1214,1214,0,0,0,0,0,0,0,1214,1214,1214,1214,1214,1214,
1214,1214,1214,1214,1214,1214,0,0,0,0,0,0,0,1214,1214,1214,1214,1214,1214,1214,1214,1214,1214,1214,1214,1214,0,0,0,0,0,0,0,0,0,0,0,0,0,0,0,0,0,0,0,0,0,0,0,0,0,0,0,0,0,0,0,1214,1214,1214,1214,1214,1214,1214,0,0,0,0,0,0,0,0,0,0,0,0,0,0,0,0,0,0,0,0,0,0,0,0,0,0,0,0,0,0,0,0,0,0,0,0,0,0,0,0,0,0,0,0,0,0,0,0,0,0,0,0,0,0,0,0,0,0,0,0,0,0,0,0,0,0,0,0,0,0,0,0,1214,1214,1214,1214,1214,1214,1214,0,0,0,0,0,0,0,0,0,0,0,0,0,0,0,0,0,0,0,0,0,0,0,0,0,0,0,0,0,0,0,1214,1214,1214,1214,1214,1214,1214,1214,1214,1214,1214,1214,1214,0,0,0,0,0,0,0,1214,1214,1214,1214,1214,1214,
1214,1214,1214,1214,1214,1214,0,0,0,0,0,0,0,1214,1214,1214,1214,1214,1214,1214,1214,1214,1214,1214,1214,1214,0,0,0,0,0,0,0,0,0,0,0,0,0,0,0,0,0,0,0,0,0,0,0,0,0,0,0,0,0,0,0,1214,1214,1214,1214,1214,1214,1214,0,0,0,0,0,0,0,0,0,0,0,0,0,0,0,0,0,0,0,0,0,0,0,0,0,0,0,0,0,0,0,0,0,0,0,0,0,0,0,0,0,0,0,0,0,0,0,0,0,0,0,0,0,0,0,0,0,0,0,0,0,0,0,0,0,0,0,0,0,0,0,0,1214,1214,1214,1214,1214,1214,1214,0,0,0,0,0,0,0,0,0,0,0,0,0,0,0,0,0,0,0,0,0,0,0,0,0,0,0,0,0,0,0,1214,1214,1214,1214,1214,1214,1214,1214,1214,1214,1214,1214,1214,0,0,0,0,0,0,0,1214,1214,1214,1214,1214,1214,
1214,1214,1214,1214,1214,1214,0,0,0,0,0,0,0,1214,1214,1214,1214,1214,1214,1214,1214,1214,1214,1214,1214,1214,0,0,0,0,0,0,0,0,0,0,0,0,0,0,0,0,0,0,0,0,0,0,0,0,0,0,0,0,0,0,0,1214,1214,1214,1214,1214,1214,1214,0,0,0,0,0,0,0,0,0,0,0,0,0,0,0,0,0,0,0,0,0,0,0,0,0,0,0,0,0,0,0,0,0,0,0,0,0,0,0,0,0,0,0,0,0,0,0,0,0,0,0,0,0,0,0,0,0,0,0,0,0,0,0,0,0,0,0,0,0,0,0,0,1214,1214,1214,1214,1214,1214,1214,0,0,0,0,0,0,0,0,0,0,0,0,0,0,0,0,0,0,0,0,0,0,0,0,0,0,0,0,0,0,0,1214,1214,1214,1214,1214,1214,1214,1214,1214,1214,1214,1214,1214,0,0,0,0,0,0,0,1214,1214,1214,1214,1214,1214,
1214,1214,1214,1214,1214,1214,0,0,0,0,0,0,0,1214,1214,1214,1214,1214,1214,1214,1214,1214,1214,1214,1214,1214,0,0,0,0,0,0,0,0,0,0,0,0,0,0,0,0,0,0,0,0,0,0,0,0,0,0,0,0,0,0,0,1214,1214,1214,1214,1214,1214,1214,0,0,0,0,0,0,0,0,0,0,0,0,0,0,0,0,0,0,0,0,0,0,0,0,0,0,0,0,0,0,0,0,0,0,0,0,0,0,0,0,0,0,0,0,0,0,0,0,0,0,0,0,0,0,0,0,0,0,0,0,0,0,0,0,0,0,0,0,0,0,0,0,1214,1214,1214,1214,1214,1214,1214,0,0,0,0,0,0,0,0,0,0,0,0,0,0,0,0,0,0,0,0,0,0,0,0,0,0,0,0,0,0,0,1214,1214,1214,1214,1214,1214,1214,1214,1214,1214,1214,1214,1214,0,0,0,0,0,0,0,1214,1214,1214,1214,1214,1214,
1214,1214,1214,1214,1214,1214,0,0,0,0,0,0,0,0,0,0,0,0,0,0,0,0,0,0,0,0,0,0,0,0,0,0,0,0,0,0,0,0,0,0,0,0,0,0,0,0,0,0,0,0,0,0,0,0,0,0,0,0,0,0,0,0,0,0,0,0,0,0,0,0,0,0,0,0,0,0,0,0,0,0,0,0,0,0,0,0,0,0,0,0,0,0,0,0,0,0,0,0,0,0,0,0,0,0,0,0,0,0,0,0,0,0,0,0,0,0,0,0,0,0,0,0,0,0,0,0,0,0,0,0,0,0,0,0,0,0,0,0,0,0,0,0,0,0,0,0,0,0,0,0,0,0,0,0,0,0,0,0,0,0,0,0,0,0,0,0,0,0,0,0,0,0,0,0,0,0,0,0,0,0,0,0,0,0,0,0,0,0,0,0,0,0,0,0,1214,1214,1214,1214,1214,1214,
1214,1214,1214,1214,1214,1214,0,0,0,0,0,0,0,0,0,0,0,0,0,0,0,0,0,0,0,0,0,0,0,0,0,0,0,0,0,0,0,0,0,0,0,0,0,0,0,0,0,0,0,0,0,0,0,0,0,0,0,0,0,0,0,0,0,0,0,0,0,0,0,0,0,0,0,0,0,0,0,0,0,0,0,0,0,0,0,0,0,0,0,0,0,0,0,0,0,0,0,0,0,0,0,0,0,0,0,0,0,0,0,0,0,0,0,0,0,0,0,0,0,0,0,0,0,0,0,0,0,0,0,0,0,0,0,0,0,0,0,0,0,0,0,0,0,0,0,0,0,0,0,0,0,0,0,0,0,0,0,0,0,0,0,0,0,0,0,0,0,0,0,0,0,0,0,0,0,0,0,0,0,0,0,0,0,0,0,0,0,0,0,0,0,0,0,0,1214,1214,1214,1214,1214,1214,
1214,1214,1214,1214,1214,1214,0,0,0,0,0,0,0,0,0,0,0,0,0,0,0,0,0,0,0,0,0,0,0,0,0,0,0,0,0,0,0,0,0,0,0,0,0,0,0,0,0,0,0,0,0,0,0,0,0,0,0,0,0,0,0,0,0,0,0,0,0,0,0,0,0,0,0,0,0,0,0,0,0,0,0,0,0,0,0,0,0,0,0,0,0,0,0,0,0,0,0,0,0,0,0,0,0,0,0,0,0,0,0,0,0,0,0,0,0,0,0,0,0,0,0,0,0,0,0,0,0,0,0,0,0,0,0,0,0,0,0,0,0,0,0,0,0,0,0,0,0,0,0,0,0,0,0,0,0,0,0,0,0,0,0,0,0,0,0,0,0,0,0,0,0,0,0,0,0,0,0,0,0,0,0,0,0,0,0,0,0,0,0,0,0,0,0,0,1214,1214,1214,1214,1214,1214,
1214,1214,1214,1214,1214,1214,0,0,0,0,0,0,0,0,0,0,0,0,0,0,0,0,0,0,0,0,0,0,0,0,0,0,0,0,0,0,0,0,0,0,0,0,0,0,0,0,0,0,0,0,0,0,0,0,0,0,0,0,0,0,0,0,0,0,0,0,0,0,0,0,0,0,0,0,0,0,0,0,0,0,0,0,0,0,0,0,0,0,0,0,0,0,0,0,0,0,0,0,0,0,0,0,0,0,0,0,0,0,0,0,0,0,0,0,0,0,0,0,0,0,0,0,0,0,0,0,0,0,0,0,0,0,0,0,0,0,0,0,0,0,0,0,0,0,0,0,0,0,0,0,0,0,0,0,0,0,0,0,0,0,0,0,0,0,0,0,0,0,0,0,0,0,0,0,0,0,0,0,0,0,0,0,0,0,0,0,0,0,0,0,0,0,0,0,1214,1214,1214,1214,1214,1214,
1214,1214,1214,1214,1214,1214,0,0,0,0,0,0,0,0,0,0,0,0,0,0,0,0,0,0,0,0,0,0,0,0,0,0,0,0,0,0,0,0,0,0,0,0,0,0,0,0,0,0,0,0,0,0,0,0,0,0,0,0,0,0,0,0,0,0,0,0,0,0,0,0,0,0,0,0,0,0,0,0,0,0,0,0,0,0,0,0,0,0,0,0,0,0,0,0,0,0,0,0,0,0,0,0,0,0,0,0,0,0,0,0,0,0,0,0,0,0,0,0,0,0,0,0,0,0,0,0,0,0,0,0,0,0,0,0,0,0,0,0,0,0,0,0,0,0,0,0,0,0,0,0,0,0,0,0,0,0,0,0,0,0,0,0,0,0,0,0,0,0,0,0,0,0,0,0,0,0,0,0,0,0,0,0,0,0,0,0,0,0,0,0,0,0,0,0,1214,1214,1214,1214,1214,1214,
1214,1214,1214,1214,1214,1214,0,0,0,0,0,0,0,0,0,0,0,0,0,0,0,0,0,0,0,0,0,0,0,0,0,0,0,0,0,0,0,0,0,0,0,0,0,0,0,0,0,0,0,0,0,0,0,0,0,0,0,0,0,0,0,0,0,0,0,0,0,0,0,0,0,0,0,0,0,0,0,0,0,0,0,0,0,0,0,0,0,0,0,0,0,0,0,0,0,0,0,0,0,0,0,0,0,0,0,0,0,0,0,0,0,0,0,0,0,0,0,0,0,0,0,0,0,0,0,0,0,0,0,0,0,0,0,0,0,0,0,0,0,0,0,0,0,0,0,0,0,0,0,0,0,0,0,0,0,0,0,0,0,0,0,0,0,0,0,0,0,0,0,0,0,0,0,0,0,0,0,0,0,0,0,0,0,0,0,0,0,0,0,0,0,0,0,0,1214,1214,1214,1214,1214,1214,
1214,1214,1214,1214,1214,1214,0,0,0,0,0,0,0,0,0,0,0,0,0,0,0,0,0,0,0,0,0,0,0,0,0,0,0,0,0,0,0,0,0,0,0,0,0,0,0,0,0,0,0,0,0,0,0,0,0,0,0,0,0,0,0,0,0,0,0,0,0,0,0,0,0,0,0,0,0,0,0,0,0,0,0,0,0,0,0,0,0,0,0,0,0,0,0,0,0,0,0,0,0,0,0,0,0,0,0,0,0,0,0,0,0,0,0,0,0,0,0,0,0,0,0,0,0,0,0,0,0,0,0,0,0,0,0,0,0,0,0,0,0,0,0,0,0,0,0,0,0,0,0,0,0,0,0,0,0,0,0,0,0,0,0,0,0,0,0,0,0,0,0,0,0,0,0,0,0,0,0,0,0,0,0,0,0,0,0,0,0,0,0,0,0,0,0,0,1214,1214,1214,1214,1214,1214,
1214,1214,1214,1214,1214,1214,0,0,0,0,0,0,0,0,0,0,0,0,0,0,0,0,0,0,0,0,0,0,0,0,0,0,0,0,0,0,0,0,0,0,0,0,0,0,0,0,0,0,0,0,0,0,0,0,0,0,0,0,0,0,0,0,0,0,0,0,0,0,0,0,0,0,0,0,0,0,0,0,0,0,0,0,0,0,0,0,0,0,0,0,0,0,0,0,0,0,0,0,0,0,0,0,0,0,0,0,0,0,0,0,0,0,0,0,0,0,0,0,0,0,0,0,0,0,0,0,0,0,0,0,0,0,0,0,0,0,0,0,0,0,0,0,0,0,0,0,0,0,0,0,0,0,0,0,0,0,0,0,0,0,0,0,0,0,0,0,0,0,0,0,0,0,0,0,0,0,0,0,0,0,0,0,0,0,0,0,0,0,0,0,0,0,0,0,1214,1214,1214,1214,1214,1214,
1214,1214,1214,1214,1214,1214,0,0,0,0,0,0,0,0,0,0,0,0,0,0,0,0,0,0,0,0,0,0,0,0,0,0,0,0,0,0,0,0,0,0,0,0,0,0,0,0,0,0,0,0,0,0,0,0,0,0,0,0,0,0,0,0,0,0,0,0,0,0,0,0,0,0,0,0,0,0,0,0,0,0,0,0,0,0,0,0,0,0,0,0,0,0,0,0,0,0,0,0,0,0,0,0,0,0,0,0,0,0,0,0,0,0,0,0,0,0,0,0,0,0,0,0,0,0,0,0,0,0,0,0,0,0,0,0,0,0,0,0,0,0,0,0,0,0,0,0,0,0,0,0,0,0,0,0,0,0,0,0,0,0,0,0,0,0,0,0,0,0,0,0,0,0,0,0,0,0,0,0,0,0,0,0,0,0,0,0,0,0,0,0,0,0,0,0,1214,1214,1214,1214,1214,1214,
1214,1214,1214,1214,1214,1214,0,0,0,0,0,0,0,0,0,0,0,0,0,0,0,0,0,0,0,0,0,0,0,0,0,0,0,0,0,0,0,0,0,0,0,0,0,0,0,0,0,0,0,0,0,0,0,0,0,0,0,0,0,0,0,0,0,0,0,0,0,0,0,0,0,0,0,0,0,0,0,0,0,0,0,0,0,0,0,0,0,0,0,0,0,0,0,0,0,0,0,0,0,0,0,0,0,0,0,0,0,0,0,0,0,0,0,0,0,0,0,0,0,0,0,0,0,0,0,0,0,0,0,0,0,0,0,0,0,0,0,0,0,0,0,0,0,0,0,0,0,0,0,0,0,0,0,0,0,0,0,0,0,0,0,0,0,0,0,0,0,0,0,0,0,0,0,0,0,0,0,0,0,0,0,0,0,0,0,0,0,0,0,0,0,0,0,0,1214,1214,1214,1214,1214,1214,
1214,1214,1214,1214,1214,1214,0,0,0,0,0,0,0,0,0,0,0,0,0,0,0,0,0,0,0,0,0,0,0,0,0,0,0,0,0,0,0,0,0,0,0,0,0,0,0,0,0,0,0,0,0,0,0,0,0,0,0,0,0,0,0,0,0,0,0,0,0,0,0,0,0,0,0,0,0,0,0,0,0,0,0,0,0,0,0,0,0,0,0,0,0,0,0,0,0,0,0,0,0,0,0,0,0,0,0,0,0,0,0,0,0,0,0,0,0,0,0,0,0,0,0,0,0,0,0,0,0,0,0,0,0,0,0,0,0,0,0,0,0,0,0,0,0,0,0,0,0,0,0,0,0,0,0,0,0,0,0,0,0,0,0,0,0,0,0,0,0,0,0,0,0,0,0,0,0,0,0,0,0,0,0,0,0,0,0,0,0,0,0,0,0,0,0,0,1214,1214,1214,1214,1214,1214,
1214,1214,1214,1214,1214,1214,0,0,0,0,0,0,0,0,0,0,0,0,0,0,0,0,0,0,0,0,0,0,0,0,0,0,0,0,0,0,0,0,0,0,0,0,0,0,0,0,0,0,0,0,0,0,0,0,0,0,0,0,0,0,0,0,0,0,0,0,0,0,0,0,0,0,0,0,0,0,0,0,0,0,0,0,0,0,0,0,0,0,0,0,0,0,0,0,0,0,0,0,0,0,0,0,0,0,0,0,0,0,0,0,0,0,0,0,0,0,0,0,0,0,0,0,0,0,0,0,0,0,0,0,0,0,0,0,0,0,0,0,0,0,0,0,0,0,0,0,0,0,0,0,0,0,0,0,0,0,0,0,0,0,0,0,0,0,0,0,0,0,0,0,0,0,0,0,0,0,0,0,0,0,0,0,0,0,0,0,0,0,0,0,0,0,0,0,1214,1214,1214,1214,1214,1214,
1214,1214,1214,1214,1214,1214,0,0,0,0,0,0,0,0,0,0,0,0,0,0,0,0,0,0,0,0,0,0,0,0,0,0,0,0,0,0,0,0,0,0,0,0,0,0,0,0,0,0,0,0,0,0,0,0,0,0,0,0,0,0,0,0,0,0,0,0,0,0,0,0,0,0,0,0,0,0,0,0,0,0,0,0,0,0,0,0,0,0,0,0,0,0,0,0,0,0,0,0,0,0,0,0,0,0,0,0,0,0,0,0,0,0,0,0,0,0,0,0,0,0,0,0,0,0,0,0,0,0,0,0,0,0,0,0,0,0,0,0,0,0,0,0,0,0,0,0,0,0,0,0,0,0,0,0,0,0,0,0,0,0,0,0,0,0,0,0,0,0,0,0,0,0,0,0,0,0,0,0,0,0,0,0,0,0,0,0,0,0,0,0,0,0,0,0,1214,1214,1214,1214,1214,1214,
1214,1214,1214,1214,1214,1214,0,0,0,0,0,0,0,0,0,0,0,0,0,0,0,0,0,0,0,0,0,0,0,0,0,0,0,0,0,0,0,0,0,0,0,0,0,0,0,0,0,0,0,0,0,0,0,0,0,0,0,0,0,0,0,0,0,0,0,0,0,0,0,0,0,0,0,0,0,0,0,0,0,0,0,0,0,0,0,0,0,0,0,0,0,0,0,0,0,0,0,0,0,0,0,0,0,0,0,0,0,0,0,0,0,0,0,0,0,0,0,0,0,0,0,0,0,0,0,0,0,0,0,0,0,0,0,0,0,0,0,0,0,0,0,0,0,0,0,0,0,0,0,0,0,0,0,0,0,0,0,0,0,0,0,0,0,0,0,0,0,0,0,0,0,0,0,0,0,0,0,0,0,0,0,0,0,0,0,0,0,0,0,0,0,0,0,0,1214,1214,1214,1214,1214,1214,
1214,1214,1214,1214,1214,1214,0,0,0,0,0,0,0,0,0,0,0,0,0,0,0,0,0,0,0,0,0,0,0,0,0,0,0,0,0,0,0,0,0,0,0,0,0,0,0,0,0,0,0,0,0,0,0,0,0,0,0,0,0,0,0,0,0,0,0,0,0,0,0,0,0,0,0,0,0,0,0,0,0,0,0,0,0,0,0,0,0,0,0,0,0,0,0,0,0,0,0,0,0,0,0,0,0,0,0,0,0,0,0,0,0,0,0,0,0,0,0,0,0,0,0,0,0,0,0,0,0,0,0,0,0,0,0,0,0,0,0,0,0,0,0,0,0,0,0,0,0,0,0,0,0,0,0,0,0,0,0,0,0,0,0,0,0,0,0,0,0,0,0,0,0,0,0,0,0,0,0,0,0,0,0,0,0,0,0,0,0,0,0,0,0,0,0,0,1214,1214,1214,1214,1214,1214,
1214,1214,1214,1214,1214,1214,1214,1214,1214,1214,1214,1214,1214,1214,1214,1214,1214,1214,1214,1214,1214,1214,1214,1214,1214,1214,1214,1214,1214,1214,1214,1214,1214,1214,1214,1214,1214,1214,1214,1214,1214,1214,1214,1214,1214,1214,1214,1214,1214,1214,1214,1214,1214,1214,1214,1214,1214,1214,1214,1214,1214,1214,1214,1214,1214,1214,1214,1214,1214,1214,1214,1214,1214,1214,1214,1214,1214,1214,1214,1214,1214,1214,1214,1214,1214,1214,1214,1214,1214,1214,1214,1214,1214,1214,1214,1214,1214,1214,1214,1214,1214,1214,1214,1214,1214,1214,1214,1214,1214,1214,1214,1214,1214,1214,1214,1214,1214,1214,1214,1214,1214,1214,1214,1214,1214,1214,1214,1214,1214,1214,1214,1214,1214,1214,1214,1214,1214,1214,1214,1214,1214,1214,1214,1214,1214,1214,1214,1214,1214,1214,1214,1214,1214,1214,1214,1214,1214,1214,1214,1214,1214,1214,1214,1214,1214,1214,1214,1214,1214,1214,1214,1214,1214,1214,1214,1214,1214,1214,1214,1214,1214,1214,1214,1214,1214,1214,1214,1214,1214,1214,1214,1214,1214,1214,1214,1214,1214,1214,1214,1214,
1214,1214,1214,1214,1214,1214,1214,1214,1214,1214,1214,1214,1214,1214,1214,1214,1214,1214,1214,1214,1214,1214,1214,1214,1214,1214,1214,1214,1214,1214,1214,1214,1214,1214,1214,1214,1214,1214,1214,1214,1214,1214,1214,1214,1214,1214,1214,1214,1214,1214,1214,1214,1214,1214,1214,1214,1214,1214,1214,1214,1214,1214,1214,1214,1214,1214,1214,1214,1214,1214,1214,1214,1214,1214,1214,1214,1214,1214,1214,1214,1214,1214,1214,1214,1214,1214,1214,1214,1214,1214,1214,1214,1214,1214,1214,1214,1214,1214,1214,1214,1214,1214,1214,1214,1214,1214,1214,1214,1214,1214,1214,1214,1214,1214,1214,1214,1214,1214,1214,1214,1214,1214,1214,1214,1214,1214,1214,1214,1214,1214,1214,1214,1214,1214,1214,1214,1214,1214,1214,1214,1214,1214,1214,1214,1214,1214,1214,1214,1214,1214,1214,1214,1214,1214,1214,1214,1214,1214,1214,1214,1214,1214,1214,1214,1214,1214,1214,1214,1214,1214,1214,1214,1214,1214,1214,1214,1214,1214,1214,1214,1214,1214,1214,1214,1214,1214,1214,1214,1214,1214,1214,1214,1214,1214,1214,1214,1214,1214,1214,1214,
1214,1214,1214,1214,1214,1214,1214,1214,1214,1214,1214,1214,1214,1214,1214,1214,1214,1214,1214,1214,1214,1214,1214,1214,1214,1214,1214,1214,1214,1214,1214,1214,1214,1214,1214,1214,1214,1214,1214,1214,1214,1214,1214,1214,1214,1214,1214,1214,1214,1214,1214,1214,1214,1214,1214,1214,1214,1214,1214,1214,1214,1214,1214,1214,1214,1214,1214,1214,1214,1214,1214,1214,1214,1214,1214,1214,1214,1214,1214,1214,1214,1214,1214,1214,1214,1214,1214,1214,1214,1214,1214,1214,1214,1214,1214,1214,1214,1214,1214,1214,1214,1214,1214,1214,1214,1214,1214,1214,1214,1214,1214,1214,1214,1214,1214,1214,1214,1214,1214,1214,1214,1214,1214,1214,1214,1214,1214,1214,1214,1214,1214,1214,1214,1214,1214,1214,1214,1214,1214,1214,1214,1214,1214,1214,1214,1214,1214,1214,1214,1214,1214,1214,1214,1214,1214,1214,1214,1214,1214,1214,1214,1214,1214,1214,1214,1214,1214,1214,1214,1214,1214,1214,1214,1214,1214,1214,1214,1214,1214,1214,1214,1214,1214,1214,1214,1214,1214,1214,1214,1214,1214,1214,1214,1214,1214,1214,1214,1214,1214,1214,
1214,1214,1214,1214,1214,1214,1214,1214,1214,1214,1214,1214,1214,1214,1214,1214,1214,1214,1214,1214,1214,1214,1214,1214,1214,1214,1214,1214,1214,1214,1214,1214,1214,1214,1214,1214,1214,1214,1214,1214,1214,1214,1214,1214,1214,1214,1214,1214,1214,1214,1214,1214,1214,1214,1214,1214,1214,1214,1214,1214,1214,1214,1214,1214,1214,1214,1214,1214,1214,1214,1214,1214,1214,1214,1214,1214,1214,1214,1214,1214,1214,1214,1214,1214,1214,1214,1214,1214,1214,1214,1214,1214,1214,1214,1214,1214,1214,1214,1214,1214,1214,1214,1214,1214,1214,1214,1214,1214,1214,1214,1214,1214,1214,1214,1214,1214,1214,1214,1214,1214,1214,1214,1214,1214,1214,1214,1214,1214,1214,1214,1214,1214,1214,1214,1214,1214,1214,1214,1214,1214,1214,1214,1214,1214,1214,1214,1214,1214,1214,1214,1214,1214,1214,1214,1214,1214,1214,1214,1214,1214,1214,1214,1214,1214,1214,1214,1214,1214,1214,1214,1214,1214,1214,1214,1214,1214,1214,1214,1214,1214,1214,1214,1214,1214,1214,1214,1214,1214,1214,1214,1214,1214,1214,1214,1214,1214,1214,1214,1214,1214
